111111111111111111111111111111
110000100100001110010000000001
100CF0C001C000000F000000000001
1F00010000000F110FCF0C0110C001
1001000000000000FF000000001F01
1CF0000C111100C00F0C0CF10F0011
10000C10000000FF100010000010F1
10001F10000000C001CF00F10100F1
100F0CF010100F0000000110F00011
10000001F000101010000000000001
1C000000C0000000000001011000C1
100C00100P111000000F00000C0001
10101F000100001000F10000000C11
10F0FF0C0000000100100000010001
100001000000000000110C011F0001
10000F0C0100C000000010C01F0001
100000F000000000010000F1101CE1
111111111111111111111111111111
