1111111111111111111
10F000000CF1C000C01
11FC001F00000001101
110000000000C110111
1000001F010FF00F011
100F0000001010010C1
1C0010000000C0010F1
1011000C00C00010001
1F00F00000101000001
1101F00000010110001
1010000C00000110001
1000F0000C000001001
1F0FC00P0010F0000E1
1111111111111111111
