11111111111111111111
10000000C100010000C1
10C00000C100F0001101
1010C10100100F00C001
100C000100000C010P11
11001F00C0F000F010F1
10000F0F000001100001
1C00F010001000F00001
11000F011F00000000C1
1F001010000000000001
10001010011000000111
10CF00F0000F0000C001
1010000000F100001111
10F1FC0000C00F000011
100110C0000000000001
11000000F0000111C001
1F01C0000F000F0001E1
11111111111111111111
