111111111111111111111111111111
10011000F0C000F00101100F100001
10000C100F011000001100CCC00FC1
100C1000F0100001FC000FC0F00101
1000000100000001C00000000C0001
100F0000000FF00110101CC00F0011
1000010000010C100000F11P010001
1000000000F000100F1000000F0001
110110F1000F1F1000000000C000E1
111111111111111111111111111111