111111111111111111111111
1000100FC0C0010010000F01
10000000C10000F0010F1101
1001100CF00F0F0P0000F001
1F001000000C0101C0000001
101000FF100C000F00000C11
100000F0C01C001C10010001
10F010001000000C00010001
1000000001000C00001F0001
100000001000100F0001F001
1011010010F0000000000001
110001010FF001000F000C01
11C1010F00000101C0100001
1C001010000FC000011000E1
111111111111111111111111