1111111111111111111
10010000000F0C00011
1C00F0C00F00000C1F1
11C110CC01000F10011
1000110100000F00011
10000000F01C0000011
1000011000F00000PC1
11001100F0001100F01
10000000000010F0011
1011000110000000001
1C0F0C000FF0F0000E1
1111111111111111111
