1111111111111111111111
110101C00FF01000101001
11001F000FF0F00F00C001
10F00CF000F010000000F1
10F0000F1000100C0F0001
10100000011000000000C1
1000000000000100001011
1000100011F00001001001
110F0101000000000CC001
100F1C0FP001000000F001
1000F0F001000001100001
10001001C11000101F0001
1C00000CC000010000F0C1
101F00000C000000000001
100000C01C0001C11000C1
11000010000000100010E1
1111111111111111111111
