111111111111111111111111111
1001C00000C1C00001010000001
1000F00110000000C0000001001
10000F000000C000CCF10001001
10F00000000F0F00F0001100001
100F010000CF0C1000000100001
110100000010110000F1000FC01
1010000100010C10000FF100F11
1000F1110C0F0000001CF000001
10P0000000C0000110001000001
11001000000F00F010000000F01
11C000FF010000000101F00C001
1000000F000FF0F010110F00001
1000000100100010000C0000F01
1000010C00C00CF010100000101
100F00000C10001000101000011
111C0100000C10F011101C00001
100C00000F0F0000010000000E1
111111111111111111111111111
