111111111111111111111
1000000C001001C0F1111
1000100010001FF010001
1C10FF01000000000C001
100000000000000C00001
10C1110000F00P0F00101
1000111010F01000C0001
10000C01FC01F00000C11
10100000FF00F0000C001
10C10000000F010110011
1000100F0F01001001001
10000100000011F000F01
10C00FC000000C0000001
101000F000000110F00E1
111111111111111111111
