11111111111111111111111
1000F000110F1100000F001
11FF0100000110F0F0CF0P1
11000000000F00010100001
1F00101C1CC00000CF0C001
1C0000000001111F000F001
1C0001000000001F0C001C1
1F000010010000C00101001
100101000000000010000E1
11111111111111111111111
