11111111111111111111
100110000F1010000001
100010001001C0000C01
1F1000C0000C00C00001
10F1100010C100000C01
1100F0000000001F0001
110C00C0F0F000100001
1000F00000100F000001
10001010F010000F0001
10000000000000010011
10010F000100000000F1
1001F0001000010101E1
11111111111111111111