111111111111111111111
1000F0F00000010010001
1F1001100C00F10000001
10C0F00011010C0F00011
1C010000001F010000001
1C00000C0001000001101
100001000000C10000001
100C0001F011001C00001
100100C100100000F0001
101000000000100001011
110001100F0F0000C0001
1F00000000000010F0001
11000010000C011000001
101F10100CC0000000001
10001FF0000000010C101
10CF00000000000000F01
10010000C0000000000E1
111111111111111111111