111111111111111111
100001001000100001
101000100C0001C001
10010F0011C00C0001
10C000000100100001
100C010000C0010001
10C0001FF0000FC001
100F000110F0F0C011
100000010000000001
1000C0000010100001
110F10000100000001
100C00011000000F01
1101C0000001001001
101110F00000010001
1000010000F01F00E1
111111111111111111