111111111111111
100C000F001C011
100C00000000001
10001000C01F0F1
110CF01000F00F1
10010C000100001
100001101010001
1001C0100000001
111F100000F00E1
111111111111111