1111111111111111111
100000F010110001F01
100011F1000000C0F11
101C000000F0C000C01
101C00CFCC0000100F1
10000000100100F0C01
1F0010F0010F00C0001
1000000010000000001
1F000F1000011000001
1000000000001010001
100001F00000101F001
10001F1C001110100E1
1111111111111111111