1111111111111111
1F01100000C0F001
100000F000000101
1001000F00CFF011
100101C000001001
100110001C100101
1000000F00100011
1000C000F100CF01
10000100F0000101
100000000000FC11
1011F00010001001
1000000001001001
110C0010000FC001
101F000001100001
1000001000000001
1100010010010001
1110CF0000000F01
1000001C00000001
10F00000C10000E1
1111111111111111